# map_type height_map
# random_seed 5857346356798609885
players 9
rows 78
cols 96
m ...%%..%%...............%......%...%%..%%...............%......%...%%..%%...............%......%
m .....%.%%%...........%.........%.....%.%%%...........%.........%.....%.%%%...........%.........%
m ....%%%%............%...%%..........%%%%............%...%%..........%%%%............%...%%......
m ....%%%%............................%%%%............................%%%%........................
m .%%%%%%%%................a%%.%...%%%%%%%%................b%%.%...%%%%%%%%................c%%.%..
m .%%%%%%%.....................%...%%%%%%%.....................%...%%%%%%%.....................%..
m ...%%%%%%%.........................%%%%%%%.........................%%%%%%%......................
m %%%%%%%%%.......................%%%%%%%%%.......................%%%%%%%%%.......................
m %%%%%%%%%%......................%%%%%%%%%%......................%%%%%%%%%%......................
m %%%%%%%%%%......................%%%%%%%%%%......................%%%%%%%%%%......................
m %%%%%%%%%%%%..............%%%%%%%%%%%%%%%%%%..............%%%%%%%%%%%%%%%%%%..............%%%%%%
m .%%%%%%%%%..................%....%%%%%%%%%..................%....%%%%%%%%%..................%...
m ..%.%%%%%%%.%.....................%.%%%%%%%.%.....................%.%%%%%%%.%...................
m ......%..%.%..........................%..%.%..........................%..%.%....................
m .......%...............................%...............................%........................
m ................................................................................................
m ................................................................................................
m ................................................................................................
m ................................................................................................
m ................................................................................................
m ................................................................................................
m ................................................................................................
m ....%...............................%...............................%...........................
m ....%...............................%...............................%...........................
m .%.%%%...........................%.%%%...........................%.%%%..........................
m %%%%%%..................%%%..%%%%%%%%%..................%%%..%%%%%%%%%..................%%%..%%%
m ...%%..%%...............%......%...%%..%%...............%......%...%%..%%...............%......%
m .....%.%%%...........%.........%.....%.%%%...........%.........%.....%.%%%...........%.........%
m ....%%%%............%...%%..........%%%%............%...%%..........%%%%............%...%%......
m ....%%%%............................%%%%............................%%%%........................
m .%%%%%%%%................d%%.%...%%%%%%%%................e%%.%...%%%%%%%%................f%%.%..
m .%%%%%%%.....................%...%%%%%%%.....................%...%%%%%%%.....................%..
m ...%%%%%%%.........................%%%%%%%.........................%%%%%%%......................
m %%%%%%%%%.......................%%%%%%%%%.......................%%%%%%%%%.......................
m %%%%%%%%%%......................%%%%%%%%%%......................%%%%%%%%%%......................
m %%%%%%%%%%......................%%%%%%%%%%......................%%%%%%%%%%......................
m %%%%%%%%%%%%..............%%%%%%%%%%%%%%%%%%..............%%%%%%%%%%%%%%%%%%..............%%%%%%
m .%%%%%%%%%..................%....%%%%%%%%%..................%....%%%%%%%%%..................%...
m ..%.%%%%%%%.%.....................%.%%%%%%%.%.....................%.%%%%%%%.%...................
m ......%..%.%..........................%..%.%..........................%..%.%....................
m .......%...............................%...............................%........................
m ................................................................................................
m ................................................................................................
m ................................................................................................
m ................................................................................................
m ................................................................................................
m ................................................................................................
m ................................................................................................
m ....%...............................%...............................%...........................
m ....%...............................%...............................%...........................
m .%.%%%...........................%.%%%...........................%.%%%..........................
m %%%%%%..................%%%..%%%%%%%%%..................%%%..%%%%%%%%%..................%%%..%%%
m ...%%..%%...............%......%...%%..%%...............%......%...%%..%%...............%......%
m .....%.%%%...........%.........%.....%.%%%...........%.........%.....%.%%%...........%.........%
m ....%%%%............%...%%..........%%%%............%...%%..........%%%%............%...%%......
m ....%%%%............................%%%%............................%%%%........................
m .%%%%%%%%................g%%.%...%%%%%%%%................h%%.%...%%%%%%%%................i%%.%..
m .%%%%%%%.....................%...%%%%%%%.....................%...%%%%%%%.....................%..
m ...%%%%%%%.........................%%%%%%%.........................%%%%%%%......................
m %%%%%%%%%.......................%%%%%%%%%.......................%%%%%%%%%.......................
m %%%%%%%%%%......................%%%%%%%%%%......................%%%%%%%%%%......................
m %%%%%%%%%%......................%%%%%%%%%%......................%%%%%%%%%%......................
m %%%%%%%%%%%%..............%%%%%%%%%%%%%%%%%%..............%%%%%%%%%%%%%%%%%%..............%%%%%%
m .%%%%%%%%%..................%....%%%%%%%%%..................%....%%%%%%%%%..................%...
m ..%.%%%%%%%.%.....................%.%%%%%%%.%.....................%.%%%%%%%.%...................
m ......%..%.%..........................%..%.%..........................%..%.%....................
m .......%...............................%...............................%........................
m ................................................................................................
m ................................................................................................
m ................................................................................................
m ................................................................................................
m ................................................................................................
m ................................................................................................
m ................................................................................................
m ....%...............................%...............................%...........................
m ....%...............................%...............................%...........................
m .%.%%%...........................%.%%%...........................%.%%%..........................
m %%%%%%..................%%%..%%%%%%%%%..................%%%..%%%%%%%%%..................%%%..%%%
