# map_type height_map
# random_seed 8364502717260382723
players 2
rows 78
cols 92
m ............................................................................................
m ............................................................................................
m ............................................................................................
m ............................................................................................
m ............................................................................................
m ............................................................................................
m ............................................................................................
m ............................................................................................
m ............................................................................................
m ............................................................................................
m ............................................................................................
m ............................................................................................
m ............................................................................................
m ............................................................................................
m ............................................................................................
m ............................................................................................
m ............................................................................................
m ............................................................................................
m ............................................................................................
m ............................................................................................
m ............................................................................................
m ............................................................................................
m ............................................................................................
m ............................................................................................
m ............................................................................................
m ............................................................................................
m ............................................................................................
m ............................................................................................
m ............................................................................................
m ............................................................................................
m ............................................................................................
m ............................................................................................
m ........%.............................................%.....................................
m ......%%..%....%%...................................%%..%....%%.............................
m .....%%%......%%%..................................%%%......%%%.............................
m ...%%%%%.....%%%.....%%..........................%%%%%.....%%%.....%%.......................
m %..%%%%.............%%%%......................%..%%%%.............%%%%......................
m %..%%%%............%%%%%......................%..%%%%............%%%%%......................
m %%%%%%%.....%..%%%%%%%%%.....%.%%............%%%%%%%%.....%..%%%%%%%%%.....%.%%............%
m %%%%%%%%....%%%%%%%%%%%%...%%%%%%%...........%%%%%%%%%....%%%%%%%%%%%%...%%%%%%%...........%
m %%%%%%%%......%%%%%%%%%%%%%%%%%%%%...........%%%%%%%%%......%%%%%%%%%%%%%%%%%%%%...........%
m %%%%%%%%....%%%%%%%%%%%%%%%%%%%%%%..%........%%%%%%%%%....%%%%%%%%%%%%%%%%%%%%%%..%........%
m %%%%%%.........%%%%%%%%%%%%%%%%%%%...%%%......%%%%%%.........%%%%%%%%%%%%%%%%%%%...%%%......
m %%%%%%%%%....%.%%%%%%%%%%%%%%%%%%%%...%%%...%%%%%%%%%%%....%.%%%%%%%%%%%%%%%%%%%%...%%%...%%
m %%%%%%%%%%...%%%%%%%%%%%%%%%%%%%%%%..%%%%%...%%%%%%%%%%%...%%%%%%%%%%%%%%%%%%%%%%..%%%%%...%
m %%%%%%%%%........%%%%%%%%%%%%%%%%%%%%%%%%%%..%%%%%%%%%%........%%%%%%%%%%%%%%%%%%%%%%%%%%..%
m .%.%.%%%...........%%%%%%%%%%%%%%%%%%%%%%%%%...%.%.%%%...........%%%%%%%%%%%%%%%%%%%%%%%%%..
m .%.%..%............%%%%%%%%%%%%%%%%%%%%%%%%%%..%.%..%............%%%%%%%%%%%%%%%%%%%%%%%%%%.
m ..................%%%%%%%%%%%%%%%%%%%%%%%%%.....................%%%%%%%%%%%%%%%%%%%%%%%%%...
m ...%%%..%%%........%%%%%%%%%%%%%%%%%%%%%%%%%.....%%%..%%%........%%%%%%%%%%%%%%%%%%%%%%%%%..
m ...%%...%%..........%%%%%%%%%%%%%%%%%%%%%%%%.....%%...%%..........%%%%%%%%%%%%%%%%%%%%%%%%..
m ...%%%%%%%..%%....%%%%%%%%%%%%%%%%%%%%%%%%%......%%%%%%%..%%....%%%%%%%%%%%%%%%%%%%%%%%%%...
m ....%%%%%%%%%%%...%%%%%%%%%%%%%%%%%%%%%%.%%.......%%%%%%%%%%%...%%%%%%%%%%%%%%%%%%%%%%.%%...
m ....%%%%%%%.......%%%%%%%%%%%%%%%%%%...%..%.......%%%%%%%.......%%%%%%%%%%%%%%%%%%...%..%...
m .....%.%%%........%%%%%%%%%%%%%%%%%...%%%..%.......%.%%%........%%%%%%%%%%%%%%%%%...%%%..%..
m ........%........%%%%%%%%%%%%%%%%.......%.............%........%%%%%%%%%%%%%%%%.......%.....
m .............%%%%%%.%%%%%%%%%%%%%%.....%.%.................%%%%%%.%%%%%%%%%%%%%%.....%.%....
m ..............%%.....%.%.%%...%%............................%%.....%.%.%%...%%..............
m ............%%...........%%...............................%%...........%%...................
m ..........................%........%....................................%........%..........
m ............%.....................%.......................%.....................%...........
m ............................................................................................
m ............................................................................................
m ............................................................................................
m ............................................................................................
m ............................................................................................
m ............................................................................................
m ............................................................................................
m ............................................................................................
m ............................................................................................
m ............................................................................................
m ............................................................................................
m ............................................................................................
m ............................................................................................
m ............................................................................................
m ............................................................................................
m ............................................................................................
m .............................................a.............................................b
