# map_type height_map
# random_seed -3416377719569030262
players 2
rows 140
cols 190
m ..............................................................................................................................................................................................
m ..............................................................................................................................................................................................
m ..............................................................................................................................................................................................
m ..............................................................................................................................................................................................
m ..............................................................................................................................................................................................
m ..............................................................................................................................................................................................
m ..............................................................................................................................................................................................
m ..............................................................................................................................................................................................
m ..............................................................................................................................................................................................
m .........%..............................................................................................%.....................................................................................
m ..............................................................................................................................................................................................
m ..............................................................................................................................................................................................
m ..............................................................................................................................................................................................
m ...................................................................................%%%............................................................................................%%%.........
m ..............................................................................................................................................................................................
m ..............................................................................................................................................................................................
m ..............................................................................................................................................................................................
m ..............................................................................................................................................................................................
m ....................................................................................%%.............................................................................................%%.........
m .....................................................................................%..............................................................................................%.........
m ..............................................................................................................................................................................................
m ..............................................................................................................................................................................................
m ....................%..............................................................................................%..........................................................................
m ..............................................................................................................................................................................................
m ..............................................................................................................................................................................................
m .............................................................................................%..............................................................................................%.
m .....................................%.......................................................%%.....................................%.......................................................%%
m .....................................%..%....................................................%......................................%..%....................................................%.
m ......................................%%%%%%.........................................................................................%%%%%%...................................................
m ......................................%%%%%%.........................................................................................%%%%%%...................................................
m .......................................%%%%...........................................................................................%%%%....................................................
m ........................................%%..............%%.............................................................................%%..............%%.....................................
m ........................................................%%%............................................................................................%%%....................................
m ...................................................%%...%%%%......................................................................................%%...%%%%...................................
m ...................................................%%%%..%%%%.....................................................................................%%%%..%%%%..................................
m ...................................................%%%%%%%%%%%%...................................................................................%%%%%%%%%%%%................................
m ...................................................%%%%%%%%%%%%%..................................................................................%%%%%%%%%%%%%...............................
m ...................................................%%%%%%%%%%%%%%.................................................................................%%%%%%%%%%%%%%..............................
m ...................................................%%%..%%%%%%%%%%................................................................................%%%..%%%%%%%%%%.............................
m ........................................................%%%%%%%%%%........%............................................................................%%%%%%%%%%........%....................
m .......................................................%%%%%%%%...........%...........................................................................%%%%%%%%...........%....................
m ......................................................%%%%%%%%%..........%%..........................................................................%%%%%%%%%..........%%....................
m .............................%......................%%%%%%%%%%%..........%%.................................................%......................%%%%%%%%%%%..........%%....................
m .............................%.....................%%%%%%%%%%............%..................................................%.....................%%%%%%%%%%............%.....................
m .............................%%....................%%%..%%%%%.........%.%%%.................................................%%....................%%%..%%%%%.........%.%%%....................
m ................%............%%....................%....%%%%%.........%.%%%....................................%............%%....................%....%%%%%.........%.%%%....................
m .................%%..........%%%........................%%%%%..........%........%%..............................%%..........%%%........................%%%%%..........%........%%.............
m ...................%.........%%.........................%%%............%%%%.......................................%.........%%.........................%%%............%%%%....................
m ................%...%........%%......%..%......%.......................%%%%%%.%%.......%.......................%...%........%%......%..%......%.......................%%%%%%.%%.......%.......
m ...............%.............%%...%%%%%%%..........%%%...................%%%%%%%..............................%.............%%...%%%%%%%..........%%%...................%%%%%%%...............
m ..............%%%%.%........%%%.%%%%%%%%%%..%......%....%..............%%%%%%%%%%............................%%%%.%........%%%.%%%%%%%%%%..%......%....%..............%%%%%%%%%%..............
m ..............%%%%......%%%.%%%%%%%%%%%%%%%%..........................%%%%%%%%%%.............................%%%%......%%%.%%%%%%%%%%%%%%%%..........................%%%%%%%%%%...............
m ..%%....%....%%%%%%%.%...%%%%%%%%%%%%%%%%%%%..............%%%.....%%%%%%%%%%%%%..................%%....%....%%%%%%%.%...%%%%%%%%%%%%%%%%%%%..............%%%.....%%%%%%%%%%%%%................
m ..%%%%%.......%%%%%........%%%%%%%%%%%%%%%%%.......%.....%%%%%%...%%%%%%%%%%%%%..................%%%%%.......%%%%%........%%%%%%%%%%%%%%%%%.......%.....%%%%%%...%%%%%%%%%%%%%................
m ..%%%%%%%%%...%%%%%%........%%%%%%%%%%%%%%%%%............%%%%....%%%%%%%%%%%%%%..................%%%%%%%%%...%%%%%%........%%%%%%%%%%%%%%%%%............%%%%....%%%%%%%%%%%%%%................
m ...%%%%%%%%%%%%%%%%%%.%.%%...%%%%%%%%%%%%%%%%%............%%%....%%%%%%%%%%%%%%...................%%%%%%%%%%%%%%%%%%.%.%%...%%%%%%%%%%%%%%%%%............%%%....%%%%%%%%%%%%%%................
m ....%%%%%%%%%%%%%%%%%%%.%....%%%%%%%%%%%%%%%%%%.............%....%%%%%%%%%%%%%%....................%%%%%%%%%%%%%%%%%%%.%....%%%%%%%%%%%%%%%%%%.............%....%%%%%%%%%%%%%%................
m ...%%%%%%%%%%%%%%%%%%%%%......%%%%%%%%%%%%%%%%%%................%%%%%%%%%%%%%%%...................%%%%%%%%%%%%%%%%%%%%%......%%%%%%%%%%%%%%%%%%................%%%%%%%%%%%%%%%................
m ...%%%%%%%%%%%%%%%%%%%%%.....%%%%%%%%%%%%%%%%%%...................%%%%%%%%%%%%%...................%%%%%%%%%%%%%%%%%%%%%.....%%%%%%%%%%%%%%%%%%...................%%%%%%%%%%%%%................
m %.%%%%%%%%%%%%%%%%%%%%%......%%%%%%%%%%%%%%%%%%%..%%....%%.........%%%%%%%%%%%%%.......%.......%.%%%%%%%%%%%%%%%%%%%%%......%%%%%%%%%%%%%%%%%%%..%%....%%.........%%%%%%%%%%%%%.......%.......
m %.%%%%%%%%%%%%%%%%%%%%%......%%%%%%%%%%%%%%%%%%%%.%%%%..%%%%%%....%%%%%%%%%%%%%%%......%%.%...%%.%%%%%%%%%%%%%%%%%%%%%......%%%%%%%%%%%%%%%%%%%%.%%%%..%%%%%%....%%%%%%%%%%%%%%%......%%.%...%
m ..%%%%%.%%%%%%%%%%%%%%%..%..%%%%%%%%%%%%%%%%%%%%%%%%%%%%%%%%%%%%%%%%%%%%%%%%%%%%%%%%....%........%%%%%.%%%%%%%%%%%%%%%..%..%%%%%%%%%%%%%%%%%%%%%%%%%%%%%%%%%%%%%%%%%%%%%%%%%%%%%%%%....%......
m .....%%..%%%%%%%%%%%%%%%%%%.%%%%%%%%%%%%%%%%%%%%%%%%%%%%%%%%%%%%%%%%%%%%%%%%%%%%%%......%%%.........%%..%%%%%%%%%%%%%%%%%%.%%%%%%%%%%%%%%%%%%%%%%%%%%%%%%%%%%%%%%%%%%%%%%%%%%%%%%......%%%....
m ..........%%%%%%%%%%%%%.%%%%%%%%%%%%%%%%%%%%%%%%%%%%%%%%%%%%%%%%%%%%%%%%..%%%...%%%%...%%%%..%%..........%%%%%%%%%%%%%.%%%%%%%%%%%%%%%%%%%%%%%%%%%%%%%%%%%%%%%%%%%%%%%%..%%%...%%%%...%%%%..%%
m ...........%%%..%%%%%%%...%%%%%%%%%%%%%%%%%%%%%%%%%%%%%%%%%%%%%%%%%%%%%%.%........%%%%%%%%%%%%%...........%%%..%%%%%%%...%%%%%%%%%%%%%%%%%%%%%%%%%%%%%%%%%%%%%%%%%%%%%%.%........%%%%%%%%%%%%%
m ..........%%%....%%%%%%.%%%%%%%%%%%%%%%%%%%%%%%%%%%%%%%%%%%%%%%%%%%%%...............%%%%%%%%%%%..........%%%....%%%%%%.%%%%%%%%%%%%%%%%%%%%%%%%%%%%%%%%%%%%%%%%%%%%%...............%%%%%%%%%%%
m ..........%.....%%%%%.%..%%%%%%%%%%%%%%%%%%%%%%%%%%%%%%%%%%%%%%%%%%%%%...............%%%%%%%%%%..........%.....%%%%%.%..%%%%%%%%%%%%%%%%%%%%%%%%%%%%%%%%%%%%%%%%%%%%%...............%%%%%%%%%%
m ..%......%.....%%%%.%...%%%%%%%%%%%%%%%%%%%%%%%%%%%%%%%%%%%%%%%%%%%%%%%...............%%%%%......%......%.....%%%%.%...%%%%%%%%%%%%%%%%%%%%%%%%%%%%%%%%%%%%%%%%%%%%%%%...............%%%%%....
m ..%%..........%%....%....%%%%%%%%%%%%%%%%%%%%%%%%%%%%%%%%%%%%%%%%%%%%%.................%%%%..%...%%..........%%....%....%%%%%%%%%%%%%%%%%%%%%%%%%%%%%%%%%%%%%%%%%%%%%.................%%%%..%.
m .............%%%...%%.......%%%%%%%%%%%%%%%%%%%%%%%%%%%%%%%%%%%%%%%%%........................%%.............%%%...%%.......%%%%%%%%%%%%%%%%%%%%%%%%%%%%%%%%%%%%%%%%%........................%%
m ..............%%%%..........%%%%%%%%%%%%%%%%%%%%%%%%%%%%%%%%%%%%%%%%%........................%%..............%%%%..........%%%%%%%%%%%%%%%%%%%%%%%%%%%%%%%%%%%%%%%%%........................%%
m %.%.............%%.%%.......%%%%%%%%%%%%%%%%%%%%%%%%%%%%%%%%%%%%%%%%........................%%%%.%.............%%.%%.......%%%%%%%%%%%%%%%%%%%%%%%%%%%%%%%%%%%%%%%%........................%%%
m %%%%%%...........%..%%%%....%%%%%%%%%%%%%%%%%%%%%%%%%%%%%%%%%%%%%%%.......................%%%%%%%%%%%...........%..%%%%....%%%%%%%%%%%%%%%%%%%%%%%%%%%%%%%%%%%%%%%.......................%%%%%
m %%%%...............%%%%%..%.%%%%%%%%%%%%%%%%%%%%%%%%%%%%%%%%%%%%%%%%......................%%%%%%%%%...............%%%%%..%.%%%%%%%%%%%%%%%%%%%%%%%%%%%%%%%%%%%%%%%%......................%%%%%
m %%%%................%%%%%.%%%%%%%%%%%%%%%%%%%%%%%%%%%%%..%%%%%%%%%%%........................%%%%%%%................%%%%%.%%%%%%%%%%%%%%%%%%%%%%%%%%%%%..%%%%%%%%%%%........................%%%
m %%%...%%.............%%%%..%%%%%%%%%%%%%%%%%%%%%%%%%%....%......%..%........................%%%%%%...%%.............%%%%..%%%%%%%%%%%%%%%%%%%%%%%%%%....%......%..%........................%%%
m %%.....%%...........%%%%%%.%%%%%%%.%%%%%%%%%%%%%%%%.....%....................................%%%%.....%%...........%%%%%%.%%%%%%%.%%%%%%%%%%%%%%%%.....%....................................%%
m %......%............%%%%%%%%%%%%....%%%%%%%%%%%%%%...........................................%%%......%............%%%%%%%%%%%%....%%%%%%%%%%%%%%...........................................%%
m %.....%%............%%%%%%%%%%%%....%%%%%%%%%%%%%%...%.......................................%%%.....%%............%%%%%%%%%%%%....%%%%%%%%%%%%%%...%.......................................%%
m %%..................%%%%%%%%%%%......%%%%%%%%%%%%..%%%%.....................................%%%%%..................%%%%%%%%%%%......%%%%%%%%%%%%..%%%%.....................................%%%
m %....%..............%%%%%%%%%.........%%%%%%%%%%%.%%%%.%%....................................%%%....%..............%%%%%%%%%.........%%%%%%%%%%%.%%%%.%%....................................%%
m %...................%%%%%%%%%%.........%%%%%%%%%%%%%%.......................................%%%%...................%%%%%%%%%%.........%%%%%%%%%%%%%%.......................................%%%
m ......%%............%%%%%%%%...........%%%%%%%%%%%%%%.........................................%......%%............%%%%%%%%...........%%%%%%%%%%%%%%.........................................%
m .....%%%.............%%%%%%%.............%%%%%%%...%%%%%............................................%%%.............%%%%%%%.............%%%%%%%...%%%%%.......................................
m ...%.%%%%.............%.%%%%.............%%%%%%......%%%..........................................%.%%%%.............%.%%%%.............%%%%%%......%%%.......................................
m .....................%..%%%%.............%%%%%......................................................................%..%%%%.............%%%%%.................................................
m .......................%%%%%..............%%.%........................................................................%%%%%..............%%.%.................................................
m ......................%.%%%%%.............%%.%.......................................................................%.%%%%%.............%%.%.................................................
m ......................%.%%%%%%.............%.%.......................................................................%.%%%%%%.............%.%.................................................
m .........................%%%%%%.........................................................................................%%%%%%................................................................
m .................%%...%...%%%%%%................................................................................%%...%...%%%%%%...............................................................
m ..........................%%%%%%.........................................................................................%%%%%%...............................................................
m ................%%........%%%%%%...............................................................................%%........%%%%%%...............................................................
m ...............%..............................................................................................%...............................................................................
m ..............................................................................................................................................................................................
m .............................................%..........................%%..................................................................%..........................%%.....................
m ........................................................................%..............................................................................................%......................
m .........................................%..............................................................................................%.....................................................
m ........................................%%%............................................................................................%%%....................................................
m ........................................%%%............................................................................................%%%....................................................
m ...................%....................%%%........%%%....%.......................................................%....................%%%........%%%....%....................................
m ....................%.................%.%%%%%%..%%%%%%%............................................................%.................%.%%%%%%..%%%%%%%........................................
m ....................%%%.............%%..%%%%%%%%%%%%%%.............................................................%%%.............%%..%%%%%%%%%%%%%%.........................................
m .....................%%............%%...%%%%.%%%%%%%%%..............................................................%%............%%...%%%%.%%%%%%%%%.........................................
m ....................%%%%...........%....%%%%.%%%%%%%%%.............................................................%%%%...........%....%%%%.%%%%%%%%%.........................................
m ......................%%%...............%%%%.%%%%%%%%%...............................................................%%%...............%%%%.%%%%%%%%%.........................................
m .........................%%.............%%%..%%%%%%%%...................................................................%%.............%%%..%%%%%%%%..........................................
m ...........................%.....................%%%%.....................................................................%.....................%%%%..........................................
m ...............................%........%.........%%..........................................................................%........%.........%%...........................................
m .........................................%.........%....................................................................................%.........%...........................................
m ..............................................................................................................................................................................................
m ..........................................%.....%........................................................................................%.....%..............................................
m ...........................................%..............................................................................................%...................................................
m ..............................................................................................................................................................................................
m ..............................................................................................................................................................................................
m ..............................................................................................................................................................................................
m ..............................................................................................................................................................................................
m ..............................................................................................................................................................................................
m ..............................................................................................................................................................................................
m ..............................................................................................................................................................................................
m ..............................................................................................................................................................................................
m ..............................................................................................................................................................................................
m ..............................................................................................................................................................................................
m ..............................................................................................................................................................................................
m ..............................................................................................................................................................................................
m ..............................................................................................................................................................................................
m ..............................................................................................................................................................................................
m ..............................................................................................................................................................................................
m ..............................................................................................................................................................................................
m ..............................................................................................................................................................................................
m ..............................................................................................................................................................................................
m ..............................................................................................................................................................................................
m ..............................................................................................................................................................................................
m ..............................................................................................................................................................................................
m ..............................................................................................................................................................................................
m ..............................................................................................................................................................................................
m ..............................................................................................................................................................................................
m ..............................................................................................................................................................................................
m ..............................................................................................................................................................................................
m ..............................................................................................a..............................................................................................b
