# map_type height_map
# random_seed 2353939094636565233
players 4
rows 108
cols 114
m ................%%..............................................................................%%................
m .................%%............................................................................%%.................
m ..................%............................................................................%..................
m ..................................................................................................................
m ..................................................................................................................
m ..................................................................................................................
m ..................................................................................................................
m .............................%...........%..............................%...........%.............................
m ...%......%................................%..........................%................................%......%...
m .%%%......%%............%.%%.%..........%...%%.%..................%.%%...%..........%.%%.%............%%......%%%.
m %%%........%.............%%%.%.........%%..%%........................%%..%%.........%.%%%.............%........%%%
m ..%%....................%%%.%%.%.......%%%%%%........................%%%%%%.......%.%%.%%%....................%%..
m .............................%..%......%%%%%%%......................%%%%%%%......%..%.............................
m ..........................%%%%.........%%%%%%........................%%%%%%.........%%%%..........................
m ...........................%%%.....%..%%%%%............................%%%%%..%.....%%%...........................
m ...........................%%%%%..%%%%%%%%..............................%%%%%%%%..%%%%%...........................
m ......%%..................%%%%%%%.%%%%%%%................................%%%%%%%.%%%%%%%..................%%......
m .....%%....................%%%%%%%%%%%%%..................................%%%%%%%%%%%%%....................%%.....
m ......%................%%%.%%.%%%%%%%%%%%................................%%%%%%%%%%%.%%.%%%................%......
m ......%................%%..%%...%%%%%%%%..................................%%%%%%%%...%%..%%................%......
m ......%..................%%.....%%%%%%%....................................%%%%%%%.....%%..................%......
m .......................%%%.......%%%%%......................................%%%%%.......%%%.......................
m ........................%%......%%%%%................%%%..%%%................%%%%%......%%........................
m ........................%.........%%%................%.%..%.%................%%%.........%........................
m .........................%.......%%%%................%......%................%%%%.......%.........................
m .........................%........%%.%......................................%.%%........%.........................
m ...................................%..........................................%...................................
m ............................a........................................................c............................
m ..................................................................................................................
m ..........................%%.......%...........%..................%...........%.......%%..........................
m ...................%%%.%%%%.........%..........%%................%%..........%.........%%%%.%%%...................
m ....................%%%%%%%........%%........................................%%........%%%%%%%....................
m %%............%%....%%%%%.........................%............%.........................%%%%%....%%............%%
m %%...%%%%.%....%....%%%%%.........................%....%..%....%.........................%%%%%....%....%.%%%%...%%
m %%.%%%%%............%%%%%.............................%%%%%%.............................%%%%%............%%%%%.%%
m %%%.................%%%%%%............................%%%%%%............................%%%%%%.................%%%
m ..................%.%%%%%%.............................%..%.............................%%%%%%.%..................
m ....%%..............%%%%%................................................................%%%%%..............%%....
m .....................%..%%..............................................................%%..%.....................
m %...%..................%%..............................%..%..............................%%..................%...%
m %%.%......%.............%...............................%%...............................%.............%......%.%%
m %%%%.%%...%............................................%%%%............................................%...%%.%%%%
m %%%%%%................................................%%%%%%................................................%%%%%%
m %%%%%%%%%..................................%...........%%%%...........%..................................%%%%%%%%%
m %%%%%%%%%%.........................%......%%%.........%%%%%%.........%%%......%.........................%%%%%%%%%%
m %%.%%%%%%%%%%.....................%%%%.....%%%%%......%%%%%%......%%%%%.....%%%%.....................%%%%%%%%%%.%%
m %%.%..%%%%%.%....................%%%%%%%...%%%%%%.....%%%%%%.....%%%%%%...%%%%%%%....................%.%%%%%..%.%%
m %%.....%..%.......................%%%%%%..%%%%%%%......%..%......%%%%%%%..%%%%%%.......................%..%.....%%
m .......%.........................%%%%%%%%%%%%%%%%................%%%%%%%%%%%%%%%%.........................%.......
m .....%%%%%........................%%%%.%%%%%%%%%%................%%%%%%%%%%.%%%%........................%%%%%.....
m ........%.........................%%%..%%%..%........................%..%%%..%%%.........................%........
m ................................%..%....%................................%....%..%................................
m ..............................%%........%................................%........%%..............................
m ...............................%..................................................%...............................
m ...............................%..................................................%...............................
m ..............................%%........%................................%........%%..............................
m ................................%..%....%................................%....%..%................................
m ........%.........................%%%..%%%..%........................%..%%%..%%%.........................%........
m .....%%%%%........................%%%%.%%%%%%%%%%................%%%%%%%%%%.%%%%........................%%%%%.....
m .......%.........................%%%%%%%%%%%%%%%%................%%%%%%%%%%%%%%%%.........................%.......
m %%.....%..%.......................%%%%%%..%%%%%%%......%..%......%%%%%%%..%%%%%%.......................%..%.....%%
m %%.%..%%%%%.%....................%%%%%%%...%%%%%%.....%%%%%%.....%%%%%%...%%%%%%%....................%.%%%%%..%.%%
m %%.%%%%%%%%%%.....................%%%%.....%%%%%......%%%%%%......%%%%%.....%%%%.....................%%%%%%%%%%.%%
m %%%%%%%%%%.........................%......%%%.........%%%%%%.........%%%......%.........................%%%%%%%%%%
m %%%%%%%%%..................................%...........%%%%...........%..................................%%%%%%%%%
m %%%%%%................................................%%%%%%................................................%%%%%%
m %%%%.%%...%............................................%%%%............................................%...%%.%%%%
m %%.%......%.............%...............................%%...............................%.............%......%.%%
m %...%..................%%..............................%..%..............................%%..................%...%
m .....................%..%%..............................................................%%..%.....................
m ....%%..............%%%%%................................................................%%%%%..............%%....
m ..................%.%%%%%%.............................%..%.............................%%%%%%.%..................
m %%%.................%%%%%%............................%%%%%%............................%%%%%%.................%%%
m %%.%%%%%............%%%%%.............................%%%%%%.............................%%%%%............%%%%%.%%
m %%...%%%%.%....%....%%%%%.........................%....%..%....%.........................%%%%%....%....%.%%%%...%%
m %%............%%....%%%%%.........................%............%.........................%%%%%....%%............%%
m ....................%%%%%%%........%%........................................%%........%%%%%%%....................
m ...................%%%.%%%%.........%..........%%................%%..........%.........%%%%.%%%...................
m ..........................%%.......%...........%..................%...........%.......%%..........................
m ..................................................................................................................
m ............................b........................................................d............................
m ...................................%..........................................%...................................
m .........................%........%%.%......................................%.%%........%.........................
m .........................%.......%%%%................%......%................%%%%.......%.........................
m ........................%.........%%%................%.%..%.%................%%%.........%........................
m ........................%%......%%%%%................%%%..%%%................%%%%%......%%........................
m .......................%%%.......%%%%%......................................%%%%%.......%%%.......................
m ......%..................%%.....%%%%%%%....................................%%%%%%%.....%%..................%......
m ......%................%%..%%...%%%%%%%%..................................%%%%%%%%...%%..%%................%......
m ......%................%%%.%%.%%%%%%%%%%%................................%%%%%%%%%%%.%%.%%%................%......
m .....%%....................%%%%%%%%%%%%%..................................%%%%%%%%%%%%%....................%%.....
m ......%%..................%%%%%%%.%%%%%%%................................%%%%%%%.%%%%%%%..................%%......
m ...........................%%%%%..%%%%%%%%..............................%%%%%%%%..%%%%%...........................
m ...........................%%%.....%..%%%%%............................%%%%%..%.....%%%...........................
m ..........................%%%%.........%%%%%%........................%%%%%%.........%%%%..........................
m .............................%..%......%%%%%%%......................%%%%%%%......%..%.............................
m ..%%....................%%%.%%.%.......%%%%%%........................%%%%%%.......%.%%.%%%....................%%..
m %%%........%.............%%%.%.........%%..%%........................%%..%%.........%.%%%.............%........%%%
m .%%%......%%............%.%%.%..........%...%%.%..................%.%%...%..........%.%%.%............%%......%%%.
m ...%......%................................%..........................%................................%......%...
m .............................%...........%..............................%...........%.............................
m ..................................................................................................................
m ..................................................................................................................
m ..................................................................................................................
m ..................................................................................................................
m ..................%............................................................................%..................
m .................%%............................................................................%%.................
m ................%%..............................................................................%%................
