# map_type height_map
# random_seed -690005370446036428
players 2
rows 71
cols 120
m ..%%%%%%%%....................................................................................................%%%%%%%%..
m ...%%%%%%%....................................................................................................%%%%%%%...
m ..%%.%%%%%%........................................%................%........................................%%%%%%.%%..
m .........%%..................................................................................................%%.........
m ..%......%....................................................................................................%......%..
m ........................................................................................................................
m ........................................................................................................................
m ........................................................................................................................
m ........................................................................................................................
m ........................................................................................................................
m ........................................................................................................................
m .....................%............................................................................%.....................
m .....................%............................................................................%.....................
m .....................%............................................................................%.....................
m %....................%..............%..............................................%..............%....................%
m ........................%........%.%%%............................................%%%.%........%........................
m ........................%.........%%%%%..........................................%%%%%.........%........................
m ........................%%.......%.%%%%%........................................%%%%%.%.......%%........................
m .........................%.%%%%..%.%%%%..............%............%..............%%%%.%..%%%%.%.........................
m ............................%%%.%%.%%%%%%%..........%..............%..........%%%%%%%.%%.%%%............................
m .............................%%....%.%.%............%..............%............%.%.%....%%.............................
m .........%..%%.................%........%%.........%%%............%%%.........%%........%.................%%..%.........
m ........%...%............................%%%........%%%..........%%%........%%%............................%...%........
m ........................................%%%%%%............................%%%%%%........................................
m ..........................................%%%%%..%....................%..%%%%%..........................................
m .......................................%...%................................%...%.......................................
m ........................................%%....................................%%........................................
m .......................................%%%....................................%%%.......................................
m ........................................%......................................%........................................
m ........................................................................................................................
m ........................................................................................................................
m ........................................................................................................................
m ........................................................................................................................
m .....%............................................................................................................%.....
m ........................................................................................................................
m ..............................a..........................................................b..............................
m ........................................................................................................................
m ........................................................................................................................
m .................%%..................................................................................%%.................
m ..................%%........%..............................................................%........%%..................
m ..................%..................................................................................%..................
m .............................%............................................................%.............................
m ................%.%%.%.%....%%............................................................%%....%.%.%%.%................
m ................%%%%%%%%..%%................................................................%%..%%%%%%%%................
m .........%.%%...%%%%%%%%%%%%%.%%........................................................%%.%%%%%%%%%%%%%...%%.%.........
m ..........%..%%..%%%%%%%%%%%%..%%%...%............................................%...%%%..%%%%%%%%%%%%..%%..%..........
m ..............%...%..%%%%%%%%..%%%%%................................................%%%%%..%%%%%%%%..%...%..............
m ...............%....%%%%%%%%%.%%%%....%..........................................%....%%%%.%%%%%%%%%....%...............
m ...............%%...%%%%%%%%%.%%%%%..................................................%%%%%.%%%%%%%%%...%%...............
m .................%..%%%%%%%%%....%%%.%....%...%%........................%%...%....%.%%%....%%%%%%%%%..%.................
m .....................%%.%..%%.....%%%%%...%%%.%..........................%.%%%...%%%%%.....%%..%.%%.....................
m ...............%%................%..%%%..%%%%..%........................%..%%%%..%%%..%................%%...............
m .....................................%...%%%%%%..........................%%%%%%...%.....................................
m .....................................%%..%%%%%%%........................%%%%%%%..%%.....................................
m ................%.................%......%%%%%%%%......................%%%%%%%%......%.................%................
m ..................................%.....%%%%%%%%%%....................%%%%%%%%%%.....%..................................
m ..................................%%...%%%%%%%%%%%....................%%%%%%%%%%%...%%..................................
m %%................................%%%.%%%%%%%%%%%%....................%%%%%%%%%%%%.%%%................................%%
m %%.................................%.%%%%%%%%%%%........................%%%%%%%%%%%.%.................................%%
m ...................%.................%%%%%%%%%%%........................%%%%%%%%%%%.................%...................
m .%..........%.....%.................%%...%%%%........%%..........%%........%%%%...%%.................%.....%..........%.
m ............%...........................%%%%%%.......%%%%......%%%%.......%%%%%%...........................%............
m ..%..%......%...........................%%%%%%......%...%%....%%...%......%%%%%%...........................%......%..%..
m .%%%.....................................%%%%%.....%%....%%..%%....%%.....%%%%%.....................................%%%.
m .%%%%....................................%%%%%%..%%%%.....%%%%.....%%%%..%%%%%%....................................%%%%.
m .%%%%%%%%.%.................................%%%%..%%%..............%%%..%%%%.................................%.%%%%%%%%.
m .%%%%%%%%%%%...............................%.%%%%%%%................%%%%%%%.%...............................%%%%%%%%%%%.
m %%%%%%%%%%%...................................%%%%%%%..............%%%%%%%...................................%%%%%%%%%%%
m .%%%%%%%%%%....................................%%.%%%..............%%%.%%....................................%%%%%%%%%%.
m .%%%%%%%%%%%...................................%..%%%..............%%%..%...................................%%%%%%%%%%%.
m .%%%%%%%%%%%.......................................%................%.......................................%%%%%%%%%%%.
