# map_type height_map
# random_seed -7438854227852617597
players 3
rows 92
cols 99
m ...................................................................................................
m ...................................................................................................
m ...................................................................................................
m ...................................................................................................
m ........%......%%.%%.....................%......%%.%%.....................%......%%.%%.............
m ............%%%%%.%%.........................%%%%%.%%.........................%%%%%.%%.............
m ............%%%%%.........%..................%%%%%.........%..................%%%%%.........%......
m ...............%%.........%.....................%%.........%.....................%%.........%......
m ............%%..........%....................%%..........%....................%%..........%........
m ...................%..%.............................%..%.............................%..%..........
m ........%.........%%.....................%.........%%.....................%.........%%.............
m ................%..%.%%..........................%..%.%%..........................%..%.%%..........
m ...............%%..%.%....%.%...................%%..%.%....%.%...................%%..%.%....%.%....
m .........%%%%%%%%.....%%%%%...............%%%%%%%%.....%%%%%...............%%%%%%%%.....%%%%%......
m .............%%%%....%%%%%%...................%%%%....%%%%%%...................%%%%....%%%%%%......
m ...............%%....%%%%%......................%%....%%%%%......................%%....%%%%%.......
m ..............%%%..%%%%........................%%%..%%%%........................%%%..%%%%..........
m ...............%%..%%%%.........................%%..%%%%.........................%%..%%%%..........
m ...................%%%..............................%%%..............................%%%...........
m ...................................................................................................
m ...................................................................................................
m ........................%................................%................................%........
m ...................................................................................................
m ...................................................................................................
m ...................................................................................................
m ...................................................................................................
m ...................................................................................................
m ...................................................................................................
m .%................................%................................%...............................
m .%%....%..........................%%....%..........................%%....%.........................
m .%.....%..........................%.....%..........................%.....%.........................
m .%.............................%..%.............................%..%.............................%.
m %%........%...............%%%%...%%........%...............%%%%...%%........%...............%%%%...
m %%.....................%%%%%%%...%%.....................%%%%%%%...%%.....................%%%%%%%...
m .....................%....%%%%%%......................%....%%%%%%......................%....%%%%%%.
m .....................%%...%%%%%%......................%%...%%%%%%......................%%...%%%%%%.
m .%..................%%%%....%%....%..................%%%%....%%....%..................%%%%....%%...
m .%...%%..............%%%%.........%...%%..............%%%%.........%...%%..............%%%%........
m .%..%%...............%%%..........%..%%...............%%%..........%..%%...............%%%.........
m .%%.%%%.%..........%.%%...........%%.%%%.%..........%.%%...........%%.%%%.%..........%.%%..........
m .%%%%%%..%.%......%%%%%%..%.%%....%%%%%%..%.%......%%%%%%..%.%%....%%%%%%..%.%......%%%%%%..%.%%...
m .%%.%....%%..%...%%%%%%%%.%%%%....%%.%....%%..%...%%%%%%%%.%%%%....%%.%....%%..%...%%%%%%%%.%%%%...
m ....%%...%%..%%%%..%%%%.....%%.......%%...%%..%%%%..%%%%.....%%.......%%...%%..%%%%..%%%%.....%%...
m .%...%....%%...%.....%......%%....%...%....%%...%.....%......%%....%...%....%%...%.....%......%%...
m .......%......%%.....%..................%......%%.....%..................%......%%.....%...........
m .....................%................................%................................%...........
m ................a................................b................................c................
m .....................%................................%................................%...........
m .....................%................................%................................%...........
m ...................................................................................................
m ...................................................................................................
m ...................................................................................................
m ...................................................................................................
m ...................................................................................................
m ...................................................................................................
m ...................................................................................................
m ...................................................................................................
m ...................................................................................................
m ...................................................................................................
m ...................................................................................................
m ...................................................................................................
m ...................................................................................................
m ................%................................%................................%................
m ...................................................................................................
m ...................................................................................................
m ...................................................................................................
m ...................................................................................................
m ...................................................................................................
m ................%................................%................................%................
m ....................%................................%................................%............
m ...................................................................................................
m ...................%%...............................%%...............................%%............
m ................%..%%............................%..%%............................%..%%............
m ................%%..%............................%%..%............................%%..%............
m %...............%%.%%............%...............%%.%%............%...............%%.%%............
m ................%%%%%%%%.........................%%%%%%%%.........................%%%%%%%%.........
m .................%%%%%%...........................%%%%%%...........................%%%%%%..........
m .........%%.....%...%%%%........%.........%%.....%...%%%%........%.........%%.....%...%%%%........%
m .......%%%%.%......%%...................%%%%.%......%%...................%%%%.%......%%............
m ....%%%%%%%........%%...%....%.......%%%%%%%........%%...%....%.......%%%%%%%........%%...%....%...
m %%%%%%%%%%......%%%%%.%%%%.%%....%%%%%%%%%%......%%%%%.%%%%.%%....%%%%%%%%%%......%%%%%.%%%%.%%....
m %%%%..%%........%%%%%%%%%%%%%%...%%%%..%%........%%%%%%%%%%%%%%...%%%%..%%........%%%%%%%%%%%%%%...
m ..%%%............%%%%%%%%%.%%%.....%%%............%%%%%%%%%.%%%.....%%%............%%%%%%%%%.%%%...
m %................%%%%%%%%.......%%................%%%%%%%%.......%%................%%%%%%%%.......%
m ...%%............%..................%%............%..................%%............%...............
m ...................................................................................................
m ...................................................................................................
m ...................................................................................................
m ...................................................................................................
m ...................................................................................................
m ...................................................................................................
m ...................................................................................................
