# map_type height_map
# random_seed 2486365963978965063
players 2
rows 62
cols 93
m ...%.........................%%%............................%%%%%%%%....................%....
m %..%.......................%%%%............................%%%%%%%%%%...................%%%..
m %.%%.%......................%%%..............................%%%%%%%%...............%..%%%...
m %.%%%%.%....................%%%.............................%%%%%%%%%%.................%...%%
m ....%%%%%...................%%%%........................%.%.%%%%%%%%%%.......................
m .%%%%%%%%..............................................%%..%%%%%%%%%%........................
m .%%%%%%%%...............................................%%.%%%%%%%%%%........................
m %%%%%%%%%....................%............................%.%.%%%%%%%........................
m %%%%%%%%..................................................%...%%%%%%%........................
m %%%%%%%%.................................................%%%..%%%%%%%........................
m %%%%%%%%......................................................%%%%%%%%......................%
m %%%%%%%.......................................................%%%%%%%%%......................
m .%%%%........................................................%%%%%%%%%%......................
m %%%%%%........................................................%%%%%%%%%%.....................
m .%%%%%........................................................%%%%%%%%%%....................%
m .%%%%%........................................a...............%%%%%%%%%....................%%
m .%.%%%...........................................%.%..........%%%%%%%%%......................
m .%.%%%...........................................%................%%%%.....................%%
m .............................................................%%%%.%%%%.......................
m ....%%...........................................%%%.........%%%....%......................%.
m .................................................%%%.........%%%...........................%.
m ..............................................%..%%%%.......%%%%%.%.......................%%.
m ..................................................%..........%%%..%..................%...%%%.
m %............................................................%%%.....................%...%%%.
m .....................................................................................%%%%%%..
m ..............................................................%.......................%%%%%%.
m .%%%..........................................................%%%.....................%%%%%%.
m .%%%..........................................................%%....................%.%%%%%%.
m ..%%%%%......................................................%%%%......................%%....
m %.%%%........................................................%%%%.%....................%.....
m ...%%......................................................%%%%%%%%......................%...
m ...%%......................................................%%%%%%%%......................%...
m %.%%%........................................................%%%%.%....................%.....
m ..%%%%%......................................................%%%%......................%%....
m .%%%..........................................................%%....................%.%%%%%%.
m .%%%..........................................................%%%.....................%%%%%%.
m ..............................................................%.......................%%%%%%.
m .....................................................................................%%%%%%..
m %............................................................%%%.....................%...%%%.
m ..................................................%..........%%%..%..................%...%%%.
m ..............................................%..%%%%.......%%%%%.%.......................%%.
m .................................................%%%.........%%%...........................%.
m ....%%...........................................%%%.........%%%....%......................%.
m .............................................................%%%%.%%%%.......................
m .%.%%%...........................................%................%%%%.....................%%
m .%.%%%...........................................%.%..........%%%%%%%%%......................
m .%%%%%........................................b...............%%%%%%%%%....................%%
m .%%%%%........................................................%%%%%%%%%%....................%
m %%%%%%........................................................%%%%%%%%%%.....................
m .%%%%........................................................%%%%%%%%%%......................
m %%%%%%%.......................................................%%%%%%%%%......................
m %%%%%%%%......................................................%%%%%%%%......................%
m %%%%%%%%.................................................%%%..%%%%%%%........................
m %%%%%%%%..................................................%...%%%%%%%........................
m %%%%%%%%%....................%............................%.%.%%%%%%%........................
m .%%%%%%%%...............................................%%.%%%%%%%%%%........................
m .%%%%%%%%..............................................%%..%%%%%%%%%%........................
m ....%%%%%...................%%%%........................%.%.%%%%%%%%%%.......................
m %.%%%%.%....................%%%.............................%%%%%%%%%%.................%...%%
m %.%%.%......................%%%..............................%%%%%%%%...............%..%%%...
m %..%.......................%%%%............................%%%%%%%%%%...................%%%..
m ...%.........................%%%............................%%%%%%%%....................%....
