# map_type height_map
# random_seed 8966127945823205628
players 6
rows 58
cols 198
m %....%%.%%%%%%%%......%%%........%....%%.%%%%%%%%......%%%........%....%%.%%%%%%%%......%%%........%....%%.%%%%%%%%......%%%........%....%%.%%%%%%%%......%%%........%....%%.%%%%%%%%......%%%........
m %....%%.%%%%%%%%%....%%%%........%....%%.%%%%%%%%%....%%%%........%....%%.%%%%%%%%%....%%%%........%....%%.%%%%%%%%%....%%%%........%....%%.%%%%%%%%%....%%%%........%....%%.%%%%%%%%%....%%%%........
m .....%%%%%%%%%%%%..%.%%%..............%%%%%%%%%%%%..%.%%%..............%%%%%%%%%%%%..%.%%%..............%%%%%%%%%%%%..%.%%%..............%%%%%%%%%%%%..%.%%%..............%%%%%%%%%%%%..%.%%%.........
m .....%%%%%%%%%%%......%%........%.....%%%%%%%%%%%......%%........%.....%%%%%%%%%%%......%%........%.....%%%%%%%%%%%......%%........%.....%%%%%%%%%%%......%%........%.....%%%%%%%%%%%......%%........%
m %....%%%%%%%%%%...........%%...%%%....%%%%%%%%%%...........%%...%%%....%%%%%%%%%%...........%%...%%%....%%%%%%%%%%...........%%...%%%....%%%%%%%%%%...........%%...%%%....%%%%%%%%%%...........%%...%%
m %%%.%%%%%%%%%%...........%%%.%%%%%%%.%%%%%%%%%%...........%%%.%%%%%%%.%%%%%%%%%%...........%%%.%%%%%%%.%%%%%%%%%%...........%%%.%%%%%%%.%%%%%%%%%%...........%%%.%%%%%%%.%%%%%%%%%%...........%%%.%%%%
m %%%%%%%%%%%%%%%%.........%.%%%%%%%%%%%%%%%%%%%%%%.........%.%%%%%%%%%%%%%%%%%%%%%%.........%.%%%%%%%%%%%%%%%%%%%%%%.........%.%%%%%%%%%%%%%%%%%%%%%%.........%.%%%%%%%%%%%%%%%%%%%%%%.........%.%%%%%%
m %%%%%%%%%%%%.....%.......%..%%%%%%%%%%%%%%%%%.....%.......%..%%%%%%%%%%%%%%%%%.....%.......%..%%%%%%%%%%%%%%%%%.....%.......%..%%%%%%%%%%%%%%%%%.....%.......%..%%%%%%%%%%%%%%%%%.....%.......%..%%%%%
m %%...%%%%%%%%.%...%...........%%%%%...%%%%%%%%.%...%...........%%%%%...%%%%%%%%.%...%...........%%%%%...%%%%%%%%.%...%...........%%%%%...%%%%%%%%.%...%...........%%%%%...%%%%%%%%.%...%...........%%%
m ......%.%%%%%%...%.............%%......%.%%%%%%...%.............%%......%.%%%%%%...%.............%%......%.%%%%%%...%.............%%......%.%%%%%%...%.............%%......%.%%%%%%...%.............%%
m ........%%%%%..%..........%..............%%%%%..%..........%..............%%%%%..%..........%..............%%%%%..%..........%..............%%%%%..%..........%..............%%%%%..%..........%......
m .........%%%%%.........%%.................%%%%%.........%%.................%%%%%.........%%.................%%%%%.........%%.................%%%%%.........%%.................%%%%%.........%%........
m ........%.%%%%%......%%%.................%.%%%%%......%%%.................%.%%%%%......%%%.................%.%%%%%......%%%.................%.%%%%%......%%%.................%.%%%%%......%%%.........
m .....................%%%%.............................%%%%.............................%%%%.............................%%%%.............................%%%%.............................%%%%........
m .......................%%%%.............................%%%%.............................%%%%.............................%%%%.............................%%%%.............................%%%%......
m .......................%%%%.............................%%%%.............................%%%%.............................%%%%.............................%%%%.............................%%%%......
m .......................%%%..............................%%%..............................%%%..............................%%%..............................%%%..............................%%%.......
m .......................%%%..............................%%%..............................%%%..............................%%%..............................%%%..............................%%%.......
m .......................%%%..............................%%%..............................%%%..............................%%%..............................%%%..............................%%%.......
m ......................................................................................................................................................................................................
m ......................................................................................................................................................................................................
m ..........................%................................%................................%................................%................................%................................%......
m ........................%................................%................................%................................%................................%................................%........
m %.....................%%%%...%.%%%.....................%%%%...%.%%%.....................%%%%...%.%%%.....................%%%%...%.%%%.....................%%%%...%.%%%.....................%%%%...%.%%
m %%%..................%.%%%%%%%%%%%%%..................%.%%%%%%%%%%%%%..................%.%%%%%%%%%%%%%..................%.%%%%%%%%%%%%%..................%.%%%%%%%%%%%%%..................%.%%%%%%%%%%
m %%%....................%%%%%%%%%%%%%....................%%%%%%%%%%%%%....................%%%%%%%%%%%%%....................%%%%%%%%%%%%%....................%%%%%%%%%%%%%....................%%%%%%%%%%
m %......................%%%%%%%%%%%......................%%%%%%%%%%%......................%%%%%%%%%%%......................%%%%%%%%%%%......................%%%%%%%%%%%......................%%%%%%%%%%
m %......................%%%%%%%%%%%......................%%%%%%%%%%%......................%%%%%%%%%%%......................%%%%%%%%%%%......................%%%%%%%%%%%......................%%%%%%%%%%
m %.......................%.%%...%%%.......................%.%%...%%%.......................%.%%...%%%.......................%.%%...%%%.......................%.%%...%%%.......................%.%%...%%
m .%..............................%.%..............................%.%..............................%.%..............................%.%..............................%.%..............................%
m ......................................................................................................................................................................................................
m ......................................................................................................................................................................................................
m ...................%%...............................%%...............................%%...............................%%...............................%%...............................%%............
m ......................................................................................................................................................................................................
m .................%%%%.............................%%%%.............................%%%%.............................%%%%.............................%%%%.............................%%%%............
m ................%%%%.............................%%%%.............................%%%%.............................%%%%.............................%%%%.............................%%%%.............
m ................%%%%%%...........................%%%%%%...........................%%%%%%...........................%%%%%%...........................%%%%%%...........................%%%%%%...........
m ................%%%%%............................%%%%%............................%%%%%............................%%%%%............................%%%%%............................%%%%%............
m .................%%%..............................%%%..............................%%%..............................%%%..............................%%%..............................%%%.............
m ...............%%%%.............................%%%%.............................%%%%.............................%%%%.............................%%%%.............................%%%%..............
m ...........%..%%%%%%........................%..%%%%%%........................%..%%%%%%........................%..%%%%%%........................%..%%%%%%........................%..%%%%%%.............
m ...........%....%%%.........................%....%%%.........................%....%%%.........................%....%%%.........................%....%%%.........................%....%%%..............
m %................................%................................%................................%................................%................................%................................
m %...............................%%...............................%%...............................%%...............................%%...............................%%...............................%
m %...%...........................%%...%...........................%%...%...........................%%...%...........................%%...%...........................%%...%...........................%
m %...............................%%...............................%%...............................%%...............................%%...............................%%...............................%
m %...............................%%...............................%%...............................%%...............................%%...............................%%...............................%
m %%............................%%%%%............................%%%%%............................%%%%%............................%%%%%............................%%%%%............................%%%
m ...............................%%...............................%%...............................%%...............................%%...............................%%...............................%%
m ......................................................................................................................................................................................................
m ......................................................................................................................................................................................................
m ......................................................................................................................................................................................................
m ......................................................................................................................................................................................................
m ......................................................................................................................................................................................................
m ......................................................................................................................................................................................................
m .......................%................................%................................%................................%................................%................................%.........
m ...........%..........%%....................%..........%%....................%..........%%....................%..........%%....................%..........%%....................%..........%%.........
m %..........%.%........%%........a%..........%.%........%%........b%..........%.%........%%........c%..........%.%........%%........d%..........%.%........%%........e%..........%.%........%%........f
