# map_type height_map
# random_seed -7033657782461116979
players 3
rows 54
cols 105
m .........................................................................................................
m .........................................................................................................
m .........................................................................................................
m ....................%..................................%..................................%..............
m ...................%..................................%..................................%...............
m .................%%%%%..............................%%%%%..............................%%%%%.............
m ...................%%%%...............................%%%%...............................%%%%............
m .............%%.%.%%%%%.........................%%.%.%%%%%.........................%%.%.%%%%%............
m ..............%%%%%%%%%%.........................%%%%%%%%%%.........................%%%%%%%%%%...........
m ..........%...%%%%%%%%%%%%...................%...%%%%%%%%%%%%...................%...%%%%%%%%%%%%.........
m ..........%..%%%%.%%%%%%%....................%..%%%%.%%%%%%%....................%..%%%%.%%%%%%%..........
m ...............%..%....%..........................%..%....%..........................%..%....%...........
m ..............%%%................................%%%................................%%%..................
m ............%.%%%%%.%..........................%.%%%%%.%..........................%.%%%%%.%..............
m .............%%%%%%.............................%%%%%%.............................%%%%%%................
m ..........%.%%%%%%%..........................%.%%%%%%%..........................%.%%%%%%%................
m ............%%%%%%%............................%%%%%%%............................%%%%%%%................
m ...........%%%%...%...........................%%%%...%...........................%%%%...%................
m ....%..........%.......................%..........%.......................%..........%...................
m ...%..........%.%.....................%..........%.%.....................%..........%.%..................
m .........................................................................................................
m .........................................................................................................
m .........................................................................................................
m .........................................................................................................
m .........................................................................................................
m .........................................................................................................
m .........................................................................................................
m ......%..........a.......................%..........b.......................%..........c.................
m ....%%%................................%%%................................%%%............................
m ....%%%%...............................%%%%...............................%%%%...........................
m .....%..................................%..................................%.............................
m ......%..................................%..................................%............................
m .........................................................................................................
m .........................................................................................................
m %%%................................%%%................................%%%................................
m %%%................................%%%................................%%%................................
m %%%................................%%%................................%%%................................
m %%%........................%......%%%%........................%......%%%%........................%......%
m %%%%......................%........%%%%......................%........%%%%......................%........
m %%.......................%........%%%.......................%........%%%.......................%........%
m %%...%.................%.%....%..%%%%...%.................%.%....%..%%%%...%.................%.%....%..%%
m %%%.....................%..%%....%%%%%.....................%..%%....%%%%%.....................%..%%....%%
m %%.......................%.%%%....%%%.......................%.%%%....%%%.......................%.%%%....%
m .%%........................%%.......%%........................%%.......%%........................%%......
m ............................%%%................................%%%................................%%%....
m ............................%%.................................%%.................................%%.....
m ...........%................%.................%................%.................%................%......
m ............................%..................................%..................................%......
m ..........%%%...............%................%%%...............%................%%%...............%......
m ..........%%...............%%%%..............%%...............%%%%..............%%...............%%%%....
m ........%.................%%%%%............%.................%%%%%............%.................%%%%%....
m .........%.................%%%%.............%.................%%%%.............%.................%%%%....
m ............................%%%................................%%%................................%%%....
m ........%..................%%%%............%..................%%%%............%..................%%%%....
