# map_type height_map
# random_seed 8816603983850105195
players 3
rows 135
cols 180
m .........................%%%................................................%......%%%%%%%%%%%.............%%%%%%%..........%%....%%%%%%%.......%%%.................................
m .........................%%%................................................%%....%%%%%%%%%%%%%......%%%%%%%%%%%%%%%%......%%%...%%%%%%%%.......%%%%.%..............................
m .........................%%%.................................................%.....%%%%%%%%%%%........%%%%%%%%%%%%%%........%%....%%%%%%.......%%%%%%%..............................
m .........................%%%................................................%%%..%%%%%%%%%%%%%%%%....%%%%%%%%%%%%%%%%.......%%%...%%%%%%.......%%%%%%%..............................
m ........................%%%%%%%............................................%%%%%%%%%%%%%%%%%%%%%%%...%%%%%%%%%%%%%%%.........%%...%%%..........%%%%%................................
m ........................%%%%%%%%%...........................................%%%%%%%%%%%%%%%%%%%%%%...%%%%%%%%%%%%%%%%.......%%%%..%%%..........%%%%%%...............................
m ........................%%%%%%%%.%.................................%........%%%%%%%%%%%%%%%%%%%%%%%..%%%%%%%%%%%%%%%%......%%%%%%.%%%%.......%%%%%%%%..%............................
m ........................%%%%%%%%.............................................%%%%%%%%%%%%%%%%%%%%%......%%%%%%%%%%..........%%%%%.%%%..........%%%%%%...............................
m ........................%%%%%%%%.............................................%%%%%%%%%%%%%%%%%%%%%......%%%%%%%%%%%%........%%%%%%%%%.........%%%%%%................................
m .......................%%%%%%%...............................................%%%%%%%%%%%%%%%%%%.........%%%%%%%%%%%%........%%%%%%%.%.........%%%%%%................................
m .......................%%%%%.................................................%%%%%%%%%%%%%%%............%%%%%%%%%%..................%............%%%................................
m ......................%%%%...................................................%%%%%%%%%%%%%%%............%%%%%%%%%%%.........%....................%%%................................
m .......................%......................................................%%%%%%%%%%%%%%..............%%%%%%%%%...............................%.................................
m .............................................................................%%%%%%%%%%%%%%%%...............%%%%%%%%................................................................
m .......................%%....................................................%%%%%%%%%%%%%%%%...........%%%.%%%%%%%%.............................%%.................................
m .......................%%....................................................%%%%%%%%%%%%%%%%%..........%%%.%%%%%%%%................................................................
m .............................................................................%%%%%%%%%%%%%%%%%%%........%%%.%%%%%%%%................................................................
m .............................................................................%%%%%%%%%%%%%%%%%%%%.......%%%%%%%%%%.%................................................................
m ..............................................................................%%%%%%%%%%%%%%%%%%.........%%%%%%%%%.................................%%...............................
m ..............................................................................%%%%%%%%%%%%%%%%%%%........%%%%%%%%%%.................................................................
m ...............................................................................%%%%%%%%%%%%%%%%%%.......%%%%%%%%%%%%..............................%%%...............................
m ................................................................................%%%%%%%%%%%%%%%%........%.%%%%%%%%%..............................%%%%%..%%..........................
m ................................................................................%%%%%%%%%%%%%%%...........%%%%%%%%%.............................%%%%%%..%...........................
m .................................................................................%%%%%%%%%%%%%%%%%%%....%%%%%%%%%%%%............................%%%%%%%.............................
m ..................................................................................%%%%%%%%%%%%%%%.%%%.....%%%%%%%%%.............................%%%%%%%.............................
m .....................................................................................%%%%%%%%%................%%%%...............................%%%%%%.............................
m ....................................................................................%%%%%%%%%%................%%%...............................%%%%%%%.............................
m ....................................................................................%%%%%%%%%%..%.............%%%.......%...........................%%..............................
m ......................................................................................%%%%%%%%%...............%%%.....%.%..........................%%%%.............................
m .....................................................................................%%%%%%.........................................................................................
m .....................................................................................%..............................................................%...............................
m .....................................................................................%.......%%.....................................................%%%.............................
m .....................................................................................%%%%%%%%%%%........................%.......................%%%%%%%.............................
m .....................................................................................%.%%...%%.....................................................%%%..............................
m .............................................................................................%......................................................%%..............................
m .........................................................................%%..........%..%...%%.....................................%................%...............................
m ..........................................................................%..........%..%..%%%......................................................................................
m ....................................................................................%%..%..%%%................%.....................................................................
m ............................................................................%.......%%...%%%%%................%.....................................................................
m ......................................................................................%...%%%%...............%%.....................................................................
m ......................................................................................%...%%%%...............%%%....................................................................
m .........................................................................................%%%%................%%%....................................................................
m ...........................................................................%%......%%%%%.%%%%%.......%%.%%%%%%%%%%................%%%%..............................................
m ...........................%................................................%%.....%%%%%%%%%%%%......%%%%%%%%%%%%.................%%%%..............................................
m ...........................%%...............................................%......%%%%%%%%%%%%......%%%%%%%%%%%%%..........%....%%%%%%%........%%%................................a
m .........................%%%................................................%......%%%%%%%%%%%.............%%%%%%%..........%%....%%%%%%%.......%%%.................................
m .........................%%%................................................%%....%%%%%%%%%%%%%......%%%%%%%%%%%%%%%%......%%%...%%%%%%%%.......%%%%.%..............................
m .........................%%%.................................................%.....%%%%%%%%%%%........%%%%%%%%%%%%%%........%%....%%%%%%.......%%%%%%%..............................
m .........................%%%................................................%%%..%%%%%%%%%%%%%%%%....%%%%%%%%%%%%%%%%.......%%%...%%%%%%.......%%%%%%%..............................
m ........................%%%%%%%............................................%%%%%%%%%%%%%%%%%%%%%%%...%%%%%%%%%%%%%%%.........%%...%%%..........%%%%%................................
m ........................%%%%%%%%%...........................................%%%%%%%%%%%%%%%%%%%%%%...%%%%%%%%%%%%%%%%.......%%%%..%%%..........%%%%%%...............................
m ........................%%%%%%%%.%.................................%........%%%%%%%%%%%%%%%%%%%%%%%..%%%%%%%%%%%%%%%%......%%%%%%.%%%%.......%%%%%%%%..%............................
m ........................%%%%%%%%.............................................%%%%%%%%%%%%%%%%%%%%%......%%%%%%%%%%..........%%%%%.%%%..........%%%%%%...............................
m ........................%%%%%%%%.............................................%%%%%%%%%%%%%%%%%%%%%......%%%%%%%%%%%%........%%%%%%%%%.........%%%%%%................................
m .......................%%%%%%%...............................................%%%%%%%%%%%%%%%%%%.........%%%%%%%%%%%%........%%%%%%%.%.........%%%%%%................................
m .......................%%%%%.................................................%%%%%%%%%%%%%%%............%%%%%%%%%%..................%............%%%................................
m ......................%%%%...................................................%%%%%%%%%%%%%%%............%%%%%%%%%%%.........%....................%%%................................
m .......................%......................................................%%%%%%%%%%%%%%..............%%%%%%%%%...............................%.................................
m .............................................................................%%%%%%%%%%%%%%%%...............%%%%%%%%................................................................
m .......................%%....................................................%%%%%%%%%%%%%%%%...........%%%.%%%%%%%%.............................%%.................................
m .......................%%....................................................%%%%%%%%%%%%%%%%%..........%%%.%%%%%%%%................................................................
m .............................................................................%%%%%%%%%%%%%%%%%%%........%%%.%%%%%%%%................................................................
m .............................................................................%%%%%%%%%%%%%%%%%%%%.......%%%%%%%%%%.%................................................................
m ..............................................................................%%%%%%%%%%%%%%%%%%.........%%%%%%%%%.................................%%...............................
m ..............................................................................%%%%%%%%%%%%%%%%%%%........%%%%%%%%%%.................................................................
m ...............................................................................%%%%%%%%%%%%%%%%%%.......%%%%%%%%%%%%..............................%%%...............................
m ................................................................................%%%%%%%%%%%%%%%%........%.%%%%%%%%%..............................%%%%%..%%..........................
m ................................................................................%%%%%%%%%%%%%%%...........%%%%%%%%%.............................%%%%%%..%...........................
m .................................................................................%%%%%%%%%%%%%%%%%%%....%%%%%%%%%%%%............................%%%%%%%.............................
m ..................................................................................%%%%%%%%%%%%%%%.%%%.....%%%%%%%%%.............................%%%%%%%.............................
m .....................................................................................%%%%%%%%%................%%%%...............................%%%%%%.............................
m ....................................................................................%%%%%%%%%%................%%%...............................%%%%%%%.............................
m ....................................................................................%%%%%%%%%%..%.............%%%.......%...........................%%..............................
m ......................................................................................%%%%%%%%%...............%%%.....%.%..........................%%%%.............................
m .....................................................................................%%%%%%.........................................................................................
m .....................................................................................%..............................................................%...............................
m .....................................................................................%.......%%.....................................................%%%.............................
m .....................................................................................%%%%%%%%%%%........................%.......................%%%%%%%.............................
m .....................................................................................%.%%...%%.....................................................%%%..............................
m .............................................................................................%......................................................%%..............................
m .........................................................................%%..........%..%...%%.....................................%................%...............................
m ..........................................................................%..........%..%..%%%......................................................................................
m ....................................................................................%%..%..%%%................%.....................................................................
m ............................................................................%.......%%...%%%%%................%.....................................................................
m ......................................................................................%...%%%%...............%%.....................................................................
m ......................................................................................%...%%%%...............%%%....................................................................
m .........................................................................................%%%%................%%%....................................................................
m ...........................................................................%%......%%%%%.%%%%%.......%%.%%%%%%%%%%................%%%%..............................................
m ...........................%................................................%%.....%%%%%%%%%%%%......%%%%%%%%%%%%.................%%%%..............................................
m ...........................%%...............................................%......%%%%%%%%%%%%......%%%%%%%%%%%%%..........%....%%%%%%%........%%%................................b
m .........................%%%................................................%......%%%%%%%%%%%.............%%%%%%%..........%%....%%%%%%%.......%%%.................................
m .........................%%%................................................%%....%%%%%%%%%%%%%......%%%%%%%%%%%%%%%%......%%%...%%%%%%%%.......%%%%.%..............................
m .........................%%%.................................................%.....%%%%%%%%%%%........%%%%%%%%%%%%%%........%%....%%%%%%.......%%%%%%%..............................
m .........................%%%................................................%%%..%%%%%%%%%%%%%%%%....%%%%%%%%%%%%%%%%.......%%%...%%%%%%.......%%%%%%%..............................
m ........................%%%%%%%............................................%%%%%%%%%%%%%%%%%%%%%%%...%%%%%%%%%%%%%%%.........%%...%%%..........%%%%%................................
m ........................%%%%%%%%%...........................................%%%%%%%%%%%%%%%%%%%%%%...%%%%%%%%%%%%%%%%.......%%%%..%%%..........%%%%%%...............................
m ........................%%%%%%%%.%.................................%........%%%%%%%%%%%%%%%%%%%%%%%..%%%%%%%%%%%%%%%%......%%%%%%.%%%%.......%%%%%%%%..%............................
m ........................%%%%%%%%.............................................%%%%%%%%%%%%%%%%%%%%%......%%%%%%%%%%..........%%%%%.%%%..........%%%%%%...............................
m ........................%%%%%%%%.............................................%%%%%%%%%%%%%%%%%%%%%......%%%%%%%%%%%%........%%%%%%%%%.........%%%%%%................................
m .......................%%%%%%%...............................................%%%%%%%%%%%%%%%%%%.........%%%%%%%%%%%%........%%%%%%%.%.........%%%%%%................................
m .......................%%%%%.................................................%%%%%%%%%%%%%%%............%%%%%%%%%%..................%............%%%................................
m ......................%%%%...................................................%%%%%%%%%%%%%%%............%%%%%%%%%%%.........%....................%%%................................
m .......................%......................................................%%%%%%%%%%%%%%..............%%%%%%%%%...............................%.................................
m .............................................................................%%%%%%%%%%%%%%%%...............%%%%%%%%................................................................
m .......................%%....................................................%%%%%%%%%%%%%%%%...........%%%.%%%%%%%%.............................%%.................................
m .......................%%....................................................%%%%%%%%%%%%%%%%%..........%%%.%%%%%%%%................................................................
m .............................................................................%%%%%%%%%%%%%%%%%%%........%%%.%%%%%%%%................................................................
m .............................................................................%%%%%%%%%%%%%%%%%%%%.......%%%%%%%%%%.%................................................................
m ..............................................................................%%%%%%%%%%%%%%%%%%.........%%%%%%%%%.................................%%...............................
m ..............................................................................%%%%%%%%%%%%%%%%%%%........%%%%%%%%%%.................................................................
m ...............................................................................%%%%%%%%%%%%%%%%%%.......%%%%%%%%%%%%..............................%%%...............................
m ................................................................................%%%%%%%%%%%%%%%%........%.%%%%%%%%%..............................%%%%%..%%..........................
m ................................................................................%%%%%%%%%%%%%%%...........%%%%%%%%%.............................%%%%%%..%...........................
m .................................................................................%%%%%%%%%%%%%%%%%%%....%%%%%%%%%%%%............................%%%%%%%.............................
m ..................................................................................%%%%%%%%%%%%%%%.%%%.....%%%%%%%%%.............................%%%%%%%.............................
m .....................................................................................%%%%%%%%%................%%%%...............................%%%%%%.............................
m ....................................................................................%%%%%%%%%%................%%%...............................%%%%%%%.............................
m ....................................................................................%%%%%%%%%%..%.............%%%.......%...........................%%..............................
m ......................................................................................%%%%%%%%%...............%%%.....%.%..........................%%%%.............................
m .....................................................................................%%%%%%.........................................................................................
m .....................................................................................%..............................................................%...............................
m .....................................................................................%.......%%.....................................................%%%.............................
m .....................................................................................%%%%%%%%%%%........................%.......................%%%%%%%.............................
m .....................................................................................%.%%...%%.....................................................%%%..............................
m .............................................................................................%......................................................%%..............................
m .........................................................................%%..........%..%...%%.....................................%................%...............................
m ..........................................................................%..........%..%..%%%......................................................................................
m ....................................................................................%%..%..%%%................%.....................................................................
m ............................................................................%.......%%...%%%%%................%.....................................................................
m ......................................................................................%...%%%%...............%%.....................................................................
m ......................................................................................%...%%%%...............%%%....................................................................
m .........................................................................................%%%%................%%%....................................................................
m ...........................................................................%%......%%%%%.%%%%%.......%%.%%%%%%%%%%................%%%%..............................................
m ...........................%................................................%%.....%%%%%%%%%%%%......%%%%%%%%%%%%.................%%%%..............................................
m ...........................%%...............................................%......%%%%%%%%%%%%......%%%%%%%%%%%%%..........%....%%%%%%%........%%%................................c
