# map_type height_map
# random_seed 221729039783966313
players 4
rows 42
cols 50
m .....%......................................%.....
m ..................................................
m ..................................................
m ....................%........%....................
m ....................%.%....%.%....................
m ...................%..........%...................
m ...............%%%.%..........%.%%%...............
m ...............%%%%%..........%%%%%...............
m .................%%............%%.................
m ...%%...........%%%............%%%...........%%...
m ..%%........a..%.%%%..........%%%.%..b........%%..
m ...%...............%..........%...............%...
m ...%%%......................................%%%...
m ..%%%%......................................%%%%..
m .%%%%%%....................................%%%%%%.
m .%.%%%......................................%%%.%.
m ...%.%..............%........%..............%.%...
m .......................%..%.......................
m ....%...............%..%..%..%...............%....
m ....%........................................%....
m ......................%....%......................
m ......................%....%......................
m ....%........................................%....
m ....%...............%..%..%..%...............%....
m .......................%..%.......................
m ...%.%..............%........%..............%.%...
m .%.%%%......................................%%%.%.
m .%%%%%%....................................%%%%%%.
m ..%%%%......................................%%%%..
m ...%%%......................................%%%...
m ...%...............%..........%...............%...
m ..%%........c..%.%%%..........%%%.%..d........%%..
m ...%%...........%%%............%%%...........%%...
m .................%%............%%.................
m ...............%%%%%..........%%%%%...............
m ...............%%%.%..........%.%%%...............
m ...................%..........%...................
m ....................%.%....%.%....................
m ....................%........%....................
m ..................................................
m ..................................................
m .....%......................................%.....
